1111111111111111
10C10000000C1111
1000011100001111
1P0C11E000001001
1111111111111111