11111111111
11E10000001
100C01P1001
11111111111