1111111111111
10C10000000C1
1000011100001
1P0C11E000001
1111111111111